L U U Q U L X L
R L R L U W U U
S L R L U L X R
U R Q R S L Q R
R U U R R R S L
S Q S L S S L R
R L R Q R L Q L
L R S R S L R L
